- अंशको: anshko=Anshko
- अच्छेता: achchheta=Achchheta
- अत्यन्त: atyant=Atyant
- अल्पविराम: alpa-viram=Alpa-viram
- आंशिक: ansik=Ansik (duplicate)
- आदिलाई: adilai=Adilai
- आरक्ष्य: aarakshya=Aarakshya
- इच्छा: ichchha=Ichchha (duplicate)
- उपलक्ष्य: upalakshya=Upalakshya
- कक्ष: kaksh=Kaksh
- कथयिता: kathayita=Kathayita
- कम्पन: kampan=Kampan
- कवर्ग: kavarga=Kavarga
- केन्द्रका: kendraka=Kendraka
- केन्द्रले: kendrale=Kendrale
- क्षण: kshan=Kshan
- क्षत: kshat=Kshat
- क्षत्रिय: kshatriya=Kshatriya
- क्षत्री: kshatri=Kshatri
- क्षमता: kshamata=Kshamata
- क्षमा: kshama=Kshama
- क्षय: kshay=Kshay
- क्षर: kshar=Kshar
- क्षितिज: kshitij=Kshitij
- क्षेत्र: kshetra=Kshetra
- क्षेपक: kshepak=Kshepak
- क्षेप्यास्त्र: kshepyastra=Kshepyastra
- क्षेम: kshem=Kshem
- गर्छ: garcha=Garchha (duplicate)
- घ: gha=Gha
- चञ्चल: chanchal=Chanchal
- चवर्ग: chavarga=Chavarga
- चिह्नको: chihnak=Chihnak
- छल: chhal=Chhal
- छिन: chhin=Chhin
- छेउ: chheu=Chheu
- छेक: chhek=Chhek
- छेत्री: chhetri=Chhetri (duplicate)
- छेपारो: chheparo=Chheparo
- छेलो: chhelo=Chhelo
- छेस्किनी: chheskini=Chheskini
- छ्या: chhya=Chhya
- छ्याङ: chhyang=Chhyang
- छ्यापछ्याप्ती: chhyapchhyapti=Chhyapchhyapti
- ज: ja=Ja
- झ: jha=Jha
- टवर्ग: tavarga=Tavarga
- ड: da=Da (duplicate)
- ढ: dha=Dha (duplicate)
- तक्षक: takshak=Takshak
- तवर्ग: tavarga=Tavarga
- दक्ष: daksh=Daksh
- दण्ड: danda=Danda (duplicate)
- दन्त: danta=Danta
- दायित्व: dayitva=Dayitva
- निक्षेप: nikshep=Nikshep
- निर्माण: nirman=Nirman (duplicate)
- पक्ष: paksha=Paksha (duplicate)
- पञ्चम: pancham=Pancham (duplicate)
- पञ्जा: panja=Panja
- पण्डित: pandit=Pandit (duplicate)
- पदावली: padavali=Padavali
- परिप्रेक्ष्य: pariprekshya=Pariprekshya
- परीक्षण: parikshan=Parikshan
- पवर्ग: pavarga=Pavarga
- पाठ्य: pathya=Pathya
- पाठ्यक्रम: pathyakram=Pathyakram
- पाठ्यपुस्तकको: pathyapustakko=Pathyapustakko
- पूर्णविराम: purnaviram=Purnaviram
- प्रत्यक्ष: pratyaksha=Pratyaksha
- प्रस्तुत: prastut=Prastut (duplicate)
- बिछ्यौना: bichhyauna=Bichhyauna
- बुँदा: bunda=Bunda
- भ: bha=Bha (duplicate)
- भएपछि: bhaepachhi=Bhaepachhi
- भक्षण: bhakshan=Bhakshan
- भक्ष्य: bhakshya=Bhakshya
- भिक्षा: bhiksha=Bhiksha
- भिक्षुक: bhikshuk=Bhikshuk
- मन्दिर: mandir=Mandir
- रक्ष्य: rakshya=Rakshya
- रछ्यान: rachhyan=Rachhyan
- रमा: rama=Rama
- रवि: ravi=Ravi
- रश्मि: rashmi=Rashmi
- राक्षस: rakshas=Rakshas
- रुक्ष: ruksh=Ruksh
- लक्षण: lakshan=Lakshan
- लक्ष्मण: lakshman=Lakshman (duplicate)
- लक्ष्य: lakshya=Lakshya
- लेख्य: lekhya=Lekhya (duplicate)
- विकास: vikas=Vikas (duplicate)
- विक्षेप: vikshep=Vikshep
- विचारशील: vicharshil=Vicharshil
- विराटनगर: viratnagar=Viratnagar
- विश्राम: vishram=Vishram (duplicate)
- शिक्षा: shiksha=Shiksha
- सक्षम: saksham=Saksham
- सङ्क्षेप: sankshyaep=Sankshyaep
- सन्देश: sandesh=Sandesh (duplicate)
- समक्ष: samaksh=Samaksh
- सम्पत्ति: sampatti=Sampatti
- सर्वेक्षण: sarvekshan=Sarvekshan
- साक्षात्: sakshyat=Sakshyat
- साक्षी: sakshi=Sakshi
- सामग्रीमा: samagrima=Samagrima
- हुँदा: huda=Huda (duplicate)
6=xa
: akshos=Akshos
And=And
Aristotles=Aristotle's
As=As
But=But
Companyz=Companies
Darwins=Darwin's
From=From
Human=Human
In=In
It=It
Life=Life
Living=Living
One=One
Others=Others
Religion=Religion
Some=Some
Text=Text
The=The
These=These
This=This
Ultimately=Ultimately
What=What
a=A
aaeko=Aayeko
aafai=aafai
aafno=aafno
aafu=aafu
aafulai=aafulai
aaghi=aghi
aairaheko=aairaheko
aaisakyo=aaisakyo
aaitabar=Aaitabar
aaj=Aaj
aaja=aaja
aajako=aaja ko
aakha=Aakha
aakhama=Aakhama
aakhir=Aakhir
aama=aama
aamabata=aama bata
aamako=aama ko
aamale=aama le
aankha=Aankha
aaphailai=Aaphailai
aath=8
aau=aau
aaunu=aaunu
aaunuhos=aaunuhos
aaunus=aaunus
aauxa=aauxa
aauxu=aauxu
aawaaj=Awaj
aawaj=Aawaj
aayo=aayo
aba=Aba
ability=Ability
about=About
absurd=Absurd
achanank=Achanak
achhel=Achel
adapt=Adapt
adapts=Adapts
addition=Addition
adharma=Adharma
adrift=Adrift
advances=Advances
aesthetic=Aesthetic
afno=Afno
agadi=Agadi
aghi=aghi
ahh=ah
ahha=ahha
ahile=ahile
ahmadle=Ahmadle
ailayand=Island
aile=ahile
ainthanle=Ainthanle
ajhai=Ajhai
aksitosisn=Oxytocin
alapatra=Stranded
ali=ali
alikati=alikati
alive=Alive
all=All
allow=Allow
allows=Allows
alok=Alok
aloklai=Aloklai
also=Also
always=Always
an=An
and=And
andhakarma=Andhakarma
andhakarmabihan=Andhakarmabihan
anek=Anek
angalo=Angalo
ani=ani
animals=Animals
animating=Animating
ansaars=Answers
ansars=Answers
answars=Answers
answarz=Answers
answer=Answer
answers=Answers
antarrastriya=Antarastriya
antatah=Antatah
antim=Antim
antya=Antya
antyasangsangai=Antyasangasangai
anubhav=Anubhav
anuttarit=Anuttarit
apart=Apart
apeksha=Apeksha
aphonlain=offline
apis=office
apisma=office ma
aplod=upload
appreciate=Appreciate
approach=Approach
apthyaro=apthyaro
are=are
arko=Arko
arkoko=Arkoko
around=Around
arthat=Arthat
asafalta=Asafalta
asali=Asali
asi=80
aspects=Aspects
asti=asti
astitwa=Astitwa
astitwagat=Astitwagat
at=At
athara=18
athawa=athawa
atma=Atma
aunchha=Aunchha
aundachha=Aundachha
avaj=Awaj
aw=ah
awaj=Awaj
awajharu=Awajharu
awasak=Awasyak
awashya=Awashya
awwaaj=Awaj
baanchne=Baanchne
baanki=Baanki
baayena=vayena
bachaunechhu=Bachaunechhu
bachiraheka=Banchiraheka
bachna=Bachna
badaliyo=Badaliyo
badhaunchhu=Badhaunchu
badhchha=Badhchha
badlieko=Badlieko
badlindaichhau=Badlindaichhau
badna=Badna
bahaanaa=Excuse
bahana=Excuse
baheniko=bahini ko
bahini=bahini
bahinii ko=bahini ko
bahiniko=bahini ko
bahinikoo=bahini ko
bahinile=bahini le
bahir=Bahir
bahiro=Bahiro
bahra=Bahra
baiphai=WiFi
bajar=bazar
bajarma=bazar ma
bajchha=Bajchha
balma=Balma
baluwama=Baluwama
banaeko=Banaeko
band=Band
banda=Banda
baniskeko=Baniskeko
banna=Banna
banta=Banta
baraf=Baraf
barha=12
barsa=barsa
barun=Brown
based=Based
baseki=Baseki
baseko=Baseko
basen=Basen
bathroom=Bathroom
bathroomtir=Bathroomtir
bayena=vayena
bayo=vayo
be=Be
beauty=Beauty
been=Been
being=Being
beings=Beings
believe=Believe
beluka=beluka
bhaayo=vayo
bhaeko=Bhaeko
bhaena=Bhaena
bhagchhu=Bhagchhu
bhagdachhau=Bhagdai Chhau
bhai=bhai
bhaigo=vaigo
bhaiile=bhai le
bhaiko=bhai ko
bhail=bhai le
bhaile=bhai le
bhairaheko=Bhairaheko
bhan=van
bhanau=Bhanau
bhanche=Bhanche
bhanchha=Bhanchha
bhanchhu=Bhanchhu
bhanchu=Bhanchhu
bhanda=vanda
bhandinu=vandinu
bhane=Bhane
bhaneki=Bhaneki
bhaneko=vaneko
bhanera=vanera
bhaniraheko=Bhaniraheko
bhaniyoos=Bhaniyos
bhanne=vanne
bhannu=vannu
bhanxhu=Bhanchhu
bhanxu=Bhanchhu
bhari=Bhari
bharidieko=Bharidieko
bhariyeko=Bhariyeko
bharkhar=bharkhar
bharosa=Trust
bharosaa=Trust
bhasha=Bhasha
bhatkinchha=Bhatkinchha
bhatsaep=WhatsApp
bhatsaepbata=WhatsApp bata
bhatsaepma=WhatsApp ma
bhaye=Bhaye
bhayena=vayena
bhayo=vayo
bheteko=Bheteko
bhetincha=Bhetincha
bhetnu=Bhetnu
bhidiyo=video
bhidiyoma=video ma
bhitra=Bhitra
bholi=bholi
bholidekhi=Bholidekhi
bholiko=Bholiko
bhram=Bhram
bhramma=Bhramma
bhuima=Bhuima
bhuinma=Bhuinma
bhutsanga=Bhutsanga
bibhinna=Bibhinna
bich_aar=Bichar
bichar=Bichar
bidesh=bidesh
bidhyalaya=school
bidhyalayama=school ma
biha=bihana
bihan=Bihan
bihana=bihana
bihibar=Bihibar
bina=Bina
biological=Biological
biology=Biology
biratnagar=Biratnagar
birsnu=Birsanu
birth=Birth
bis=20
bistarai=Bistarai
bitchha=Bitchha
biyar=Beer
biyogka=Biyogaka
blututh=Bluetooth
bodies=Bodies
braaun=Brown
brain=Brain
braun=Brown
brawn=Brown
breakthroughs=Breakthroughs
broader=Broader
broun=Brown
brown=Brown
buba=buba
bubako=buba ko
bubale=buba le
budha=budha
budhabar=Budhabar
budhi=budhi
butwal=Butwal
buwa=buwa
buwako=buwa ko
buwale=buwa le
by=By
byaktiko=Byaktiko
byare=byare
byawaharko=Byawaharko
capacity=Capacity
celebrate=Celebrate
centuries=Centuries
cha=xa
chaarko=Charko
chah=chai
chahanchhau=Chahanchhau
chahanchu=Chahanchu
chahi=Chahi
chahinchha=Chahinchha
chai=chai
chaina=xaina
chaliraheko=Chaliraheko
chalis=40
chan=xan
chance=Chance
changing=Changing
char=4
charako=Charko
charkko=Charko
charko=Charko
chau=xau
chaubis=Chaubis
chaudha=14
chaw=xau
chemical=Chemical
cherish=Cherish
chetana=Chetana
chha=6
chhaina=xaina
chhala=Chhala
chhalmuni=Chhalamuni
chhan=xan
chhar=Char
chhau=xau
chhaun=Chhaun
chhe=Chhe
chhetra=Chhetra
chhhan=xan
chhodchhu=Chhodchu
chhodi=Chhodi
chhodna=Chhodna
chhodne=Chhodne
chhora=chhora
chhori=chhori
chhoro=Chhoro
chhoroo=Chhoro
chhu=xu
chhunuunda=Chhunuunda
chhuwai=Chhuwai
chichyaairaheko=Chichyaairaheko
chichyauchhu=Chichyaunchu
chichyaunchha=Chichyaunchha
chichyaunchhu=Chichyaunchu
chichyaunchoo=Chichyaunchu
chichyaunxu=Chichyaunchu
chichyauunchu=Chichyaunchu
chihanma=Chihanma
chilaaunchu=Chilaunchu
chilaaunxu=Chilaunchu
chilauchhu=Chilaunchu
chilaun=Chilaun
chilaunchha=Chilaunchha
chilaunchhu=Chilaunchu
chilaunchoo=Chilaunchu
chinne=Chinne
chiso=Chiso
chitwan=Chitwan
choro=Chhoro
chorro=Chhoro
chu=xu
code=Code
cognition=Cognition
college=college
collegema=college ma
companyj=Companies
complex=Complex
complexities=Complexities
concept=Concept
conclusion=Conclusion
consciousness=Consciousness
consider=Consider
constantly=Constantly
contemplate=Contemplate
continue=Continue
core=Core
cosmic=Cosmic
cosmos=Cosmos
countless=Countless
create=Create
cycle=Cycle
daar=Dar
dada=dada
dadako=dada ko
dadale=dada le
dai=dai
daiko=dai ko
daile=dai le
dar=Dar
daraeki=Daraeki
darlagdo=Darlagdo
darr=Dar
darshaniharule=Darshaniharule
das=10
daunlod=download
de=de
death=Death
debates=Debates
deen=din
deepened=Deepened
deeper=Deeper
defies=Defy
definition=Definition
definitions=Definitions
definitive=Definitive
definitively=Definitively
dekhchhu=Dekhchhu
dekhidaina=Dekhidaina
dekhinchha=Dekhinchha
delving=Delving
depth=Depth
depths=Depths
desh=desh
design=Design
destiny=Destiny
deta=data
detama=data ma
deu=deu
develop=Develop
dhaar=Dar
dhalchhu=Dhalchu
dharan=Dharan
dharma=Dharma
dherai=dherai
dhoka=Betrayal
dhoka bahir=Dhokabahir
dhokaa=Betrayal
dhokabaahir=Dhokabahir
dhokabahir=Dhokabahir
dhokabahira=Dhokabahir
didaina=didaina
didi=didi
didiko=didi ko
didile=didi le
dieko=Dieko
diena=diyena
dimag=Dimag
dimagbhitra=Dimagbhitra
dimagka=Dimagka
dimagle=Dimagle
dimagma=Dimagma
din=din
dinadekhi=Dinadekhi
dine=dine
dinn=din
dinu=dinu
dinuhos=dinuhos
dinus=dinus
discovery=Discovery
discussions=Discussions
distinguishes=Distinguishes
diuso=diuso
divine=Divine
dixa=dinxa
dixu=dinxu
diyo=diyo
dna=DNA
dopamin=Dopamine
dosro=Dosro
dubeko=Dubeko
dui=2
dukchha=Dukchha
dukha haruko=Dukhaharuko
duniya=World
duniyaa=World
duwai=Duvai
dyn=din
easy=Easy
eghara=11
ek=1
ekarkaka=Ekarkaka
ekdam=ekdam
ekjana=Ekjana
ekkasi=Ekkasi
ekko=Ekko
eklai=Eklai
eklopan=Eklopana
ekpatak=Ekpatak
elusive=Elusive
emotions=Emotions
enigmatic=Enigmatic
enlightenment=Enlightenment
ensars=Answers
environment=Environment
ep=app
epis=app
eps=app
essay=Essay
essence=Essence
ethical=Ethical
euta=Euta
even=Even
evolution=Evolution
evolve=Evolve
evolves=Evolves
existence=Existence
existential=Existential
experience=Experience
experiences=Experiences
experiencing=Experiencing
explore=Explore
expression=Expression
faculties=Faculties
failiraheko=Failiraheko
failirahekoo=Failiraheko
failirheko=Failiraheko
faith=Faith
faliraheko=Failiraheko
farkana=Farkana
farmal=Formal
farmol=Formal
fascinated=Fascinated
feel=Feel
fesabuk=Facebook
fesabukbata=Facebook bata
fesabukma=Facebook ma
fesbuk=Facebook
fesbukbata=Facebook bata
fesbukma=Facebook ma
for=For
formal=Formal
formol=Formal
forms=Forms
forth=Forth
foto=photo
fotoharu=photo haru
fragile=Fragile
from=From
fulfill=Fulfill
function=Function
fundamental=Fundamental
future=Future
fyaankidinchhe=Fyaankidinchhe
fyaankidinshchu=Fyaankidinchu
fyaankna=Fyaankna
gaaryo=garyo
gaaryoo=garyo
gaeka=Gaeka
gaeko=Gaeko
gaera=Gaera
gahro=gahro
gain=gaina
gairaheko=gairaheko
gairiraheki=Gariraheki
gaisakyo=gaisakyo
galat=Galat
gar=gar
gara=gara
garau=Garau
garchha=garxa
garchhan=garxan
garchhin=garxin
garchhu=garxu
garchu=garxu
garda=garda
gardaenaan=Gardainan
gardaianan=Gardainan
gardaina=gardaina
gardainan=Gardainan
gardainann=Gardainan
gardainna=Gardainan
gardina=gardina
gare=Gare
gareko=gareko
garera=garera
gari=Gari
gari raheki=Gariraheki
garib=Poor
garidinu=garidinu
garidinus=garidinus
gariraheki=Gariraheki
gariraheko=Gariraheko
garirahheki=Gariraheki
garmi=Garmi
garna=garna
garne=garne
garnema=Garnema
garnu=garnu
garnus=garnus
garo=garyo
garryo=garyo
garyo=garyo
gate=Gate
gau=gau
gauma=gau ma
gaun=Gaun
gayena=gayena
gayo=gayo
geet=Geet
generations=Generations
genetic=Genetic
ghanta=ghanta
ghar=ghar
gharbata=ghar bata
ghari=ghari
gharma=ghar ma
ghateko=Ghateko
ghisrindai=Ghisrindai
ghumirahanchha=Ghumirahanchha
ghumiraheka=Ghumiraheka
gif=Gift
giff=Gift
gift=Gift
gihft=Gift
gipht=Gift
gipt=Gift
give=Give
gives=Gives
governs=Governs
gram=Gram
grand=Grand
grappled=Grappled
group=Group
grow=Grow
growth=Growth
gugal=Google
gugalma=Google ma
guide=Guide
gunastar=Gunastar
haddibhitra=Haddibhitra
hae=hai
hai=hai
haii=hai
hain=haina
haina=haina
haisiyat=Status
hajar=1000
hajarao=Hajaraun
hajarau=Hajaraun
hajarauN=Hajaraun
hajaraun=Hajaraun
hajaroN=Hajaraun
hajur=hajur
hajuraama=hajuraama
hajurba=hajurba
hajurko=hajur ko
hajurlai=hajur lai
hajurle=hajur le
halchhe=Halchhe
hami=hami
hamiharu=hamiharu
hamilai=hamilai
hamile=hamile
hamro=hamro
haraunechha=Haraunecha
hardawar=hardware
harek=Harek
haren=Haren
harnechhu=Harnechu
has=huss
haso=Haso
hastaakshar=Signature
hat=Haat
hatma=Hatma
hatyar=Hatiyar
hatyarbat=Hatiyarbata
hatyarkai=Hatiyarkai
hatyarko=Hatiyarko
hatyarlai=Hatiyarlai
hatyarle=Hatiyarle
have=Have
hay=hai
hei=hai
her=her
herchhu=Herchhu
herchu=herxu
herda=herda
herdachhan=Herdai Chhan
herkchu=herxu
herkhu=herxu
herna=Herna
herne=herne
hernu=hernu
hernuhos=hernuhos
hernus=hernus
herxa=herxa
herxhu=herxu
herxu=herxu
heryo=heryo
higher=Higher
hijo=hijo
hijodekhi=Hijodekhi
history=History
ho=ho
hoina=Hoina
hoki=Hoki
hola=hola
holan=holan
hos=Hos
hudadudai=Hundahundai
hudaina=Hudaina
humanity=Humanity
hun=hun
huna=Huna
huncha=hunxa
hunchan=hunxan
hunchha=hunxa
hunchhan=hunxan
hunchhu=hunxu
hunchu=hunxu
hune=Hune
hunechha=Hunechha
hunhcan=hunxan
huni=huni
hunu=Hunu
hunuhuncha=hunuhunxa
hunuhunchha=hunuhunxa
hunupardacha=Hunupardachha
hunxaan=hunxan
hunxhan=hunxan
huss=huss
hwatsep=WhatsApp
hwatsepma=WhatsApp ma
hyas=Hash
ichchhashakti=Ichchhashakti
imaan=Honesty
iman=Honor
important=Important
impossible=Impossible
in=In
inanimate=Inanimate
india=India
indifferent=Indifferent
individual=Individual
information=Information
interpretations=Interpretations
into=Into
introspection=Introspection
inviting=Inviting
is=Is
iskul=school
iskulma=school ma
its=Its
ja=ja
jaa=ja
jaat=Jaat
jab=Jab
jabbsam=Jabasamma
jadaina=jadaina
jadina=jadina
jaha=Jaha
jalaune=Jalaune
jameko=Jameko
jamin=Land
jan=jana
janakari=Jankari
jancha=janxa
janchha=janxa
janchhu=janxu
janchu=janxu
janda=Janda
jane=jane
janma=Janma
janmieko=Janmiyeko
janu=janu
janubhayo=janubhayo
januhos=januhos
janus=janus
jasari=Jasari
jasko=jasko
jaslai=jaslai
jasle=jasle
jastai=Jastai
jasto=Jasto
jatiko=Jatiko
jau=Jaau
jeet=Jeet
jel=Jail
jhai=jhai
jhan=Jhan
jhapa=Jhapa
jharda=Jharda
jhuti=Jhuti
jhyal=Jhyal
jindaagee=Jindaki
jindage=Jindaki
jindagee=Jindaki
jindagi=Jindaki
jindagiko=Jindagiko
jiwan=Jiwan
jiwankai=Jiwankai
jiwanko=Jiwanko
jiwanlai=Jiwanlai
jiwanma=Jiwanma
jo=jo
joke=Joke
julay=July
just=Just
jyai=jhai
k=k
kaampchha=Kaampchha
kaampchhu=Kaampchu
kaampiraheko=Kaampiraheko
kabiharule=Kabiharule
kadam=Kadam
kah=kaha
kaha=kaha
kahanir=Kahanir
kahila=kahile
kahilaa=kahile
kahilai=Kahilyai
kahile=kahile
kahilekahi=kahilekahi
kahilyai=Kahilyai
kahilye=kahile
kaila=kahile
kaile=kahile
kak=kaka
kaka=kaka
kakale=kaka le
kaki=kaki
kal=Call
kalakhandako=Kalakhandako
kalakhandama=Kalakhandama
kalamko=Kalamko
kaleja=college
kalejma=college ma
kalpana=Kalpana
kam=kam
kama=kam
kambal=Blanket
kamera=camera
kamila=Kamila
kamjor=Kamjor
kamma=kam ma
kampiraheko=Kampiraheko
kampyutar=computer
kampyutarma=computer ma
karan=Karan
karmaachaari=Employee
karod=10000000
karyaalaya=Office
karyakaksh=Office room
kasaile=Kasaile
kasaisanga=Kasaisanga
kasari=kasari
kasko=kasko
kaslai=Kaslai
kasle=kasle
kaso=kaso
kata=kata
katabata=kata bata
katha=Katha
kathako=Kathako
kathmandu=Kathmandu
kati=kati
katikher=Katikhera
katro=katro
ke=k
kee=Ki
keebord=keyboard
keena=kina
kehi=Kehi
kehibaata=Kehibata
keina=kina
kemikalharu=Chemicalharu
key=Key
keybooard=keyboard
keybord=keyboard
kha=kha
khaanuhos=khanuhos
khadai=khadai
khali=Khali
khalipan=Khalipan
khanchha=Khanchha
khandaina=khandaina
khandina=khandina
khane=khane
khanu=khanu
khanu hos=khanuhos
khanuhos=khanuhos
khanuhosh=khanuhos
khanuhoss=khanuhos
khanus=khanus
khanxa=khanxa
khanxu=khanxu
khao=khau
khau=khau
khayena=khayena
khayo=khayo
khojchhu=Khojchu
khojna=Khojna
kholchha=Kholchha
kholchhhu=Kholchu
kholchhu=Kholchu
kholna=Kholna
kholxu=Kholchu
khulchha=Khulchha
khulepachhi=Khulepachhi
khulyo=Khulyo
khutta=Khutta
ki=Ki
kibal=cable
kibod=keyboard
kibord=keyboard
kibourd=keyboard
kii=Ki
kin=kina
kina=kina
kinaa=kina
kinaki=kinaki
kinar=Kinar
kinna=kina
ko=ko
kohi=Kohi
kohika=Kohika
kohikaa=Kohika
koika=Kohika
kompyutar=computer
koon=kun
kootha=kotha
koslai=kaslai
kota=kotha
kotha=kotha
kothaa=kotha
kothabat=Kothabat
kothama=kotha ma
kothatir=Kothatir
kothha=kotha
koun=kun
koyika=Kohika
kritrim=Kritrim
ksau=xau
kshanik=Kshanik
kun=kun
kunai=Kunai
kune=kun
kuni=kunni
kunn=kun
kura=Kura
kurako=Kurako
kurdachhu=Kurdai Chhu
kursi=Chair
kyare=kyare
l=la
la=la
ladain=Ladain
ladchhaun=Ladchaun
ladchhu=Ladchu
laddai=Laddai
lader=Lader
ladne=Ladne
lagaun=Lagauna
lagauna=Lagauna
lagaunchha=Lagaunchha
lagchha=Lagchha
lagdai=Lagdai
lagi=Lagi
lagupadartha=Lagupadartha
lagupadarthale=Lagupadarthale
lagyo=Lagyo
laiphle=Lifele
laitarma=Lighterma
lakh=100000
lakshya=Lakshya
laptap=laptop
laptapma=laptop ma
lat=Lat
latbichako=Latabichako
lau=lau
learn=Learn
lehkney=lekhne
lekh=lekh
lekhdai=Lekhdai
lekhdaii=Lekhdai
lekhdey=Lekhdai
lekhdhai=Lekhdai
lekhen=lekhena
lekhne=lekhne
lekhney=lekhne
lekhnu=lekhnu
lekhnuhos=lekhnuhos
lekhus=lekhnus
lekhxa=lekhxa
lekhxu=lekhxu
lekhyo=lekhyo
lekne=lekhne
lessons=Lessons
lida=lida
lieko=Lieko
light=Light
line=line
linga=Linga
link=link
linkma=link ma
linu=linu
linuhos=linuhos
linuparchha=Linuparchha
linus=linus
liu=liu
lives=Lives
living=Living
liyera=liyera
liyo=liyo
long=Long
love=Love
lu=lu
lyaiyeko=Lyaieko
ma=ma
maama=mama
mabata=ma bata
madhye=Madhye
mafi=Apology
mahango=mahango
mahasus=Mahasus
mahatwapurn=Mahatwapurna
mahina=mahina
mahinaama=Mahinama
mahinadekhi=Mahinadekhi
maiju=maiju
maile=maile
malai=malai
maldivs=Maldives
maldivsko=Maldivesko
male=Malé
maleiko=Maléko
maleko=Maléko
malekoo=Maléko
malyko=Maléko
mam=mama
mama=mama
mamale=mama le
mamma=mama
mammaa=mama
man=Man
manav=Manav
manbichko=Manbichko
manche=Manche
manchhe=Manchhe
manchheharu=Manchheharu
mangalbar=Mangalbar
manifestations=Manifestations
manisko=Manisko
manko=Manko
manner=Manner
manobigyanle=Manobigyanle
manobigyanma=Manobigyanma
mansik=Mansik
manspeshi=Manspeshi
marchha=Marchha
marchhu=Marchu
mardaichha=Mardaichha
mardaichhan=Mardaichhan
marne=Marne
masanga=Masanga
masenjar=Messenger
masenjarma=Messenger ma
masi=Masi
mathi=Mathi
mathin=Mathin
matra=matra
matrai=Matrai
matter=Matter
maulik=Maulik
maus=mouse
mausam=Season
may=May
maya=Maya
meaning=Meaning
meaningless=Meaningless
means=Means
mechanism=Mechanism
mere=Mere
merely=Merely
mero=mero
mesenjar=Messenger
mesenjarbata=Messenger bata
mesenjarm=Messenger ma
mesenjarma=Messenger ma
metine=Metine
mihinet=Hard work
mile=Mile
minet=minute
mitho=Mitho
miti=Miti
mobail=mobile
mobailbata=mobile bata
mobaille=mobile le
mobailma=mobile ma
modern=Modern
moral=Moral
more=More
mrityu=Mrityu
mukh=Mukh
mukti=Mukti
muktiko=Muktiko
multifaceted=Multifaceted
mulyangkan=Mulyankan
muskaan=Smile
muskan=Smile
mystery=Mystery
nabbai=90
nabbe=90
nachhunu=Nachhunu
nahuna=Nahuna
nahune=Nahune
nai=nai
nainty=90
nakkal=Nakkal
nam=Nam
nanggo=Nanggo
narak=Narak
naramro=naramro
nasakne=Nasakne
natra=natra
natural=Natural
nature=Nature
nau=9
naya=naya
nepal=Nepal
nepali=Nepali
nepaliko=Nepaliko
nepalma=Nepalma
neuroscience=Neuroscience
new=New
ni=ni
nidra=Nidra
nihshulk=Nihshulka
nikai=nikai
nilo=Nilo
ninety=90
ninty=90
nirmanko=Nirmanko
nirnaya=Nirnaya
nischit=Nischit
niskinu=Niskinu
no=No
non-living=Non-living
not=Not
note=Note
nuances=Nuances
objects=Objects
ochhyan=Ochhyan
ochhyanbat=Ochhyanbat
odhchhu=Odhchu
odio=audio
of=Of
offering=Offering
office=office
officema=office ma
ok=ok
okaay=okay
okay=okay
okey=okay
okkay=okay
on=On
one=One
onlain=online
open=Open
or=Or
organism=Organism
organisms=Organisms
other=Other
our=Our
pachas=50
pachhillo=Pachhillo
pachi=paxi
packet=Packet
paeko=Paeko
pagal=Pagal
pahila=pahila
pahilo=Pahilo
pahilochoti=Pahilochoti
paile=paile
paincha=Paincha
paisa=Paisa
paisaa=Money
paiyos=Paiyos
pakkai=pakkai
paltaudai=Paltaudai
pana=Pana
panai=Panai
panale=Panale
panama=Panama
panch=5
pandhra=15
pani=pani
paradox=Paradox
paraunthi=Paraunthi
parayas=Prayas
parchha=Parchha
pare=Pare
paribar=paribar
parinat=Parinat
pariwarako=Parivarako
parsi=parsi
part=Part
particular=Particular
paryapta=Paryapta
pasaal=pasal
pasal=pasal
pasall=pasal
pasalma=pasal ma
pasaport=passport
pasel=pasal
pass=Pass
passaall=pasal
pataak=Patak
patak=Patak
patta=Patta
paunema=Paunema
paxi=paxi
payau=Payau
perhaps=Perhaps
perplexed=Perplexed
perspectives=Perspectives
pesha=Pesha
pet=Pet
peti=Pavement
phailiraheko=Failiraheko
pharak=Farak
pharker=Pharker
pharkinchhu=Pharkinchhu
phela=Fela
phenomena=Phenomena
phenomenon=Phenomenon
phesbuk=Facebook
phesbukbata=Facebook bata
phesbukle=Facebook le
phesbukma=Facebook ma
philosophers=Philosophers
philosophy=Philosophy
phon=Phone
phone=Phone
phoolsanga=Phoolsanga
phoor=Poor
phormal=Formal
phota=photo
photoharu=photo haru
physical=Physical
physicality=Physicality
picche=Picche
pinjara=Pinjara
plan=Plan
planbat=Planebat
planbyat=Planebat
played=Played
plenbat=Planebat
plenbyat=Planebat
plenbyt=Planebat
po=po
poets=Poets
pokhara=Pokhara
por=Poor
praayas=Prayas
prashna=Prashna
pratikriya=Pratikriya
prayaas=Prayas
prayas=Prayas
prays=Prayas
precious=Precious
prem=Prem
premkho=Premko
principle=Principle
process=Process
products=Products
profound=Profound
pur=Poor
pura=Pura
purakaharu=Purakaharu
puranau=purano
purano=purano
puranoo=purano
puranou=purano
purna=Purna
purpose=Purpose
puryaun=Puryauna
pusal=pasal
pustak=Pustak
pustakko=Pustakko
put=Put
puur=Poor
puzzled=Puzzled
pyaket=Packet
question=Question
questions=Questions
ra=ra
raat=Raat
rahanchha=Rahanchha
rahasya=Rahasya
rahechha=Rahechha
rakhe=Rakhe
rakheko=Rakheko
ramro=ramro
random=Random
rang=Color
rangharu=Rangharu
rasayanik=Rasayanik
rat=Raat
rati=rati
raudha=Raudha
raudhale=Raudhale
reactions=Reactions
reason=Reason
reasoning=Reasoning
remain=Remain
remains=Remains
reproduction=Reproduction
richness=Richness
riddle=Riddle
risortma=Resortma
roirahanchhu=Roirahanchu
rokidainan=Rokidainan
room=room
rooom=room
roum=room
rum=room
rume=room
rumma=room ma
rupma=Rupma
ruum=room
saalko=Saalko
saanchai=Saanchai
sabai=Sabai
sabai bhanda=Sabaibhanda
sabaibhanda=Sabaibhanda
sabaiko=Sabaiko
sabaile=Sabaile
sabdhaharu=Sabdaharu
sabhyatako=Sabhyatako
sachai=Sanchai
sadak=Road
sadakalaka=Sadakalaka
sadhai=sadhai
sadupayog=Sadupayog
sahaaraa=Support
sahara=Support
saharko=Saharko
sahayog=Sahayog
sahi=Sahi
saij=size
saijako=size ko
sajha=sajha
sajilo=sajilo
sakcha=Sakcha
sakchha=Sakchha
sakdacha=Sakdacha
sakdina=Sakdina
sakidaina=Sakidaina
sakinchha=Sakinchha
sakiyera=Sakiyera
sakne=Sakne
salvation=Salvation
samagra=Samagra
samajko=Samajko
samajma=Samajma
samanya=Samanya
samaya=samaya
samayako=Samayako
sambandha=Sambandha
samudra=Samudra
samudrako=Samudrako
samudralai=Samudralai
samudri=Samudri
san=xan
sang=Sanga
sanga=Sanga
sangai=Sangai
sange=Sanga
sangga=Sanga
sanibar=Sanibar
sano=sano
sansarka=Sansarka
santan=Santan
santushti=Santushti
santushtika=Santushtika
santushtikha=Santushtika
santustika=Santushtika
santustikaa=Santushtika
santwanadai=Santwanadayi
sapana=Sapana
saphtawar=software
sarai=sarai
sarddhanjalima=Shraddhanjalima
sarko=Sarko
sasto=sasto
sat=7
sath=Sath
sathi=60
sathibhai=sathibhai
sathiharu=sathi haru
sathiko=sathi ko
sathile=sathi le
satra=17
satta=Satta
sattakai=Sattakai
sattako=Sattako
sattalai=Sattalai
sattale=Sattale
sattari=70
sattra=17
satya=Satya
saya=100
sayad=sayad
scientific=Scientific
scientists=Scientists
seat=Seat
sebbenti=70
sebenteen=17
sebenti=70
see=See
sekend=second
self-awareness=Self-awareness
senses=Senses
series=Series
serotonin=Serotonin
set=Set
sets=Sets
settati=70
seventeen=17
seventy=70
shabda=Shabda
shabdabat=Shabdabata
shahar=sahar
shaharma=sahar ma
sharir=Sharir
sharma=Sharma
shauchalay=Toilet
shauchalaymai=Shauchalaymai
shed=Shed
should=Should
shriman=shriman
shrimati=shrimati
shubh=Shubh
shukrabaar=Sukrabar
shukrabar=Sukrabar
sidhanta=Siddhanta
sight=Sight
significance=Significance
sim=SIM
simit=Simit
simkard=SIM card
simply=Simply
singdi=Singdhi
sisa=Sisa
six=xa
skrin=screen
skrinma=screen ma
skul=school
sochera=Sochera
sochheka=Socheka
sochne=Sochne
sodheko=Sodheko
sombar=Sombar
something=Something
sorha=16
sparked=Sparked
spiritual=Spiritual
state=State
struggle=Struggle
study=Study
sugar=Sugar
sugarm=Sugarma
suit=Suit
sukarbar=Sukrabar
sukrabaar=Sukrabar
sukrabar=Sukrabar
sun=sun
suna=suna
sundaina=sundaina
sundar=sundar
sundina=sundina
sunena=sunena
suninchha=Suninchha
sunne=sunne
sunnita=Sunyata
sunnu=sunnu
sunnuhos=sunnuhos
sunnuhunxa=sunnuhunxa
sunus=sunnus
sunxa=sunxa
sunxu=sunxu
sunyo=sunyo
suru=Suru
suruat=Suruat
surudekhi=Surudekhi
suruwat=Suruwat
survival=Survival
surya=Surya
sustain=Sustain
sut=Suit
sutna=Sutna
swarga=Swarga
swargama=Swargama
swikriti=Swikriti
t=ta
ta=ta
tab=Tab
taba=Taba
tadha=Tadha
taile=taile
taim=time
talai=talai
tan=Tan
tapai=tapai
tapaibata=tapai bata
tapaiko=tapaiko
tapailai=tapailai
tapaile=tapaile
tapain=tapai
tar=Tar
tara=tara
tatha=Tatha
taul=Taul
tayal=Tile
tayar=Tayar
teek=thik
terha=13
tero=tero
tesro=Tesro
thaha=Thaha
thalchha=Thalchha
thaleko=Thaleko
than=Than
that=That
thau=Thau
the=The
their=Their
theme=Theme
theory=Theory
there=There
these=These
thie=Thiye
thien=Thien
thii=Thii
thik=thik
thikh=thik
thikk=thik
think=Think
this=This
thiyen=Thiye
thiyo=Thiyo
thorai=thorai
thrive=Thrive
through=Through
throughout=Throughout
thulo=thulo
ti=Ti
ti bhi=TV
tibhi=TV
tibhibata=TV bata
tibhima=TV ma
tibi=TV
tikaeko=Tikaeko
tikiraheko=Tikirheko
timeless=Timeless
times=Times
timi=timi
timiharu=timiharu
timilai=timilai
timile=timile
timro=timro
tin=3
tini=tini
tis=30
tivi=TV
to=To
towards=Towards
tradition=Tradition
transcends=Transcend
trishna=Trishna
trishnako=Trishnako
trishnale=Trishnale
trishnasangako=Trishnasangako
truly=Truly
tukra=Tukra
tulana=Tulana
tutdai=Tutdai
tuteko=Tuteko
tyahan=Tyahan
tyahi=Tyahi
tyahin=Tyahin
tyasaile=tyasaile
tyasari=Tyasari
tyasko=tyasko
tyaslai=tyaslai
tyasle=tyasle
tyaso=Tyaso
tyaspachhi=Tyaspachhi
tyasto=Tyasto
tyo=tyo
u=u
uchhu=Uthchu
ultimate=Ultimate
umm=um
understanding=Understanding
uni=uni
uniharoo=Uniharu
uniharuko=Uniharuko
unique=Unique
unknowability=Unknowability
unko=unko
unlai=unilai
unle=unle
unnais=19
unparalleled=Unparalleled
unravel=Unravel
unresolved=Unresolved
us=Us
usalaai=uslai
uskko=usko
usko=usko
uslaai=uslai
uslai=uslai
usle=usle
usu ko=usko
usuku=usko
uthaen=Uthaen
uthna=Uthna
utpadan=Utpadan
utpanna=Utpanna
vaayo=vayo
vaena=vayena
various=Various
vast=Vast
very=Very
vicharharu=Vichaharharu
wa=wa
waiphai=WiFi
warnako=Warnako
wastavik=Vastavik
wastawik=Bastabik
wastawikta=Bastabikta
watsap=WhatsApp
watsapma=WhatsApp ma
way=Way
we=We
welana=Velana
what=What
which=Which
whole=Whole
will=Will
wimansthal=Vimansthal
with=With
wonder=Wonder
world=World
yaaha=Yaha
yadi=Yadi
yahN=Yaha
yaha=Yaha
yahaa=Yaha
yahaan=Yaha
yahan=Yahan
yahi=Yahi
yapan=Yapan
yasko=yasko
yaslai=yaslai
yasle=yasle
yasto=Yasto
yathawat=Yathawat
yati=Yati
yatra=Yatra
yatrama=Yatrama
yi=yi
yini=yini
yo=yo
yuddha=Yuddha
yutyub=YouTube
yutyubbat=YouTube bata
yutyubbata=YouTube bata
yutyuble=YouTube le
yutyubma=YouTube ma
yuva=Yuva
शिक्षा=Shiksha
नियमावली=Niyamawali
राजपत्रमा=Rajpatrama
प्रकाशित=Prakashit
मिति=Miti
संशोधन=Sanshodhan
पहिलो=Pahilo
दोस्रो=Dosro
तेस्रो=Tesro
चौथो=Chautho
पाँचौं=Panchau
आर=Aar
छैठौं=Chaithau
सातौं=Satau
आठौं=Aathau
ऐन=Ain
को=Ko
दफा=Dapha
ले=Le
दिएको=Dieko
अधिकार=Adhikar
प्रयोग=Prayog
गरी=Gari
नेपाल=Nepal
सरकारले=Sarakarle
देहायका=Dehayaka
परिच्छेद=Parichchhed
प्रारम्भिक=Prarambhik
संक्षिप्त=Sanchhipta
नाम=Naam
र=Ra
प्रारम्भः=Prarambha
यी=Yi
नियमहरुको=Niyamaharuko
रहेकोछ=Rahekochha
यो=Yo
तुरुन्त=Turunta
हुनेछ=Hunechha
परिभाषाः=Paribhasha
विषय=Bishay
वा=Wa
प्रसङ्गले=Prasangale
अर्को=Arko
अर्थ=Artha
नलागेमा=Nalagema
यस=Yas
नियमावलीमा=Niyamawalima
भन्नाले=Bhannale
सम्झनु=Samjhanu
पर्छ=Parchha
मन्त्रालय=Mantralay
सरकार=Sarakar
विभाग=Bibhag
FT=FT
महानिर्देशक=Mahanirdeshak
विभागको=Bibhagako
निर्देशनालय=Nirdeshanalay
क्षेत्रीय=Kshetriy
निर्देशनालयको=Nirdeshanalayako
निरीक्षक=Nirikshak
विद्यालयको=Bidyalayako
निरीक्षण=Nirikshan
गर्न=Garna
तोकिएको=Tokieko
कर्मचारी=Karmachari
समुदायद्वारा=Samudayadwara
सञ्चालित=Sanchalit
विद्यालय=Bidyalay
बमोजिम=Bamojim
स्थानीय=Sthaniya
निकाय=Nikay
व्यवस्थापन=Byabasthapan
समितिले=Samitile
जिम्मा=Jimma
लिएको=Lieko
सामुदायिक=Samudayik
सामुदायिकशिक्षक=SamudayikShikshak
नेपालसरकारबाट=NepalSarakarbat
स्वीकृत=Swikrit
दरबन्दी=Darbandi
अन्तर्गत=Antargat
नियुक्त=Niyukta
गरेको=Gareko
स्थायी=Sthayi
शिक्षक=Shikshak
नेमार=Nemar
छनौट=Chhanaut
छनौटसमिति=ChhanautSamiti
परीक्षा=Pariksha
निम्न=Nimna
माध्यमिक=Madhyamik
उत्तीर्ण=Uttrina
संशोधनद्वारा=Sanshodhandwara
थप=Thap
संशोधित=Sanshodhit
झिकिएको=Jhikieko
शैक्षिक=Shaikshik
सत्र=Satra
अध्ययन=Adhyayan
अध्यापन=Adhyapan
गराइने=Garaine
वार्षिक=Barshik
अवधि=Awadhi
अनौपचारिक=Anaupacharik
दिइने=Diine
दूर=Dur
पत्राचार=Patrachar
श्रव्य=Shravya
दृश्य=Drishya
संचार=Sanchar
माध्यमबाट=Madhyamabat
कुनै=Kunai
विषयमा=Bishayama
शिशु=Shishu
विकास=Bikas
केन्द्र=Kendra
चार=Char
वर्ष=Barsha
पूरा=Pura
नभएका=Nabhaeka
बालबालिकालाई=Balabalikalai
शारीरिक=Sharirik
मानसिक=Manasik
वौद्धिक=Bauddhik
दिनको=Dinako
लागि=Lagi
खोलिएको=Kholieko
जनशक्ति=Janshakti
परिषद्=Parishad
प्रधानाध्यापक=Pradhanadhyapak
परिवार=Pariwar
शिक्षकसँग=Shikshaksanga
एकासगोलमा=Ekasagolma
बस्ने=Basne
तथा=Tatha
निज=Nij
आफैंले=Aafainle
पालनपोषण=Palanposhan
पर्ने=Parne
पति=Pati
पत्नी=Patni
छोरा=Chhora
धर्मपुत्र=Dharmaputra
अविवाहित=Abibahit
छोरी=Chhori
धर्मपुत्री=Dharmaputri
बाबु=Babu
आमा=Aama
सौतेनी=Sauteni
सो=So
शब्दले=Shabdale
पुरुष=Purush
शिक्षकको=Shikshakko
हकमा=Hakma
निजको=Nijko
बाजे=Baje
बज्यै=Bajyai
महिला=Mahila
सासू=Sasu
ससुरा=Sasura
समेतलाई=Sametlai
जनाउँछ=Janauchha
किताबखाना=Kitabkhana
किताब=Kitab
खाना=Khana
शुल्क=Shulka
विद्यालयले=Bidyalayale
विद्यार्थीसँग=Bidyarthisanga
लिन=Lina
पाउने=Paune
सञ्चालक=Sanchalak
समिति=Samiti
ऐनको=Ainako
गठन=Gathan
भएको=Bhaeko
ग्रामीण=Gramin
कोष=Kosh
योग=Yog
खोल्ने=Kholne
अनुमति=Anumati
स्वीकृति=Swikriti
सम्बन्धी=Sambandhi
व्यवस्था=Byabastha
खोल्नको=Kholnako
पूर्वाधार=Purbadhar
हुनु=Hunu
दिनेः=Dine
सम्बन्धमा=Sambandhama
निवेदन=Nibedan
परेमा=Parema
जिल्ला=Jilla
अधिकारीले=Adhikrile
निवेदनसाथ=Nibedansath
प्राप्त=Prapta
कागजात=Kagajat
जाँचबुझ=Janchabujh
गर्नेछ=Garnechha
गर्दा=Garda
त्यसरी=Tyasari
खोलिने=Kholine
गाउँ=Gau
नगरपालिकाको=Nagarpalikako
सिफारिस=Sipharis
सहित=Sahit
अनुसूची=Anusuchi
ढाँचामा=Dhachama
अधिकारी=Adhikari
समक्ष=Samakshya
दिनु=Dinu
पर्नेछ=Parnechha
पूर्व=Purba
चाहनेले=Chahanale
हुनुभन्दा=Hunubhanda
कम्तीमा=Kamtima
दुई=Dui
महिना=Mahina
अगावै=Agawai
नगरपालिका=Nagarpalika
सुरु=Suru
देखिएमा=Dekhima
आफैले=Aafaile
विद्यालयखोल्ने=BidyalayaKholne
अनुमतिसम्बन्धमा=AnumatiSambandhama
निर्धारण=Nirdharan
संख्याको=Sankhyako
अधीनमा=Adhinama
रही=Rahi
बाहेक=Bahek
शर्तहरु=Shartaharu
सरकारबाट=Sarakarbat
पाठ्यक्रम=Pathyakram
पाठ्यपुस्तक=Pathyapustak
लागू=Lagu
पाठ्यसामग्री=Pathyasamagri
नहुने=Nahune
राष्ट्रियताप्रति=Rashtriyataprati
आँच=Aanch
आउने=Aaune
पाठ्य=Pathy
सामग्री=Samagri
रकममा=Rakamma
नघटाई=Naghatai
अभिभावकको=Abhibhabakko
भेला=Bhela
गराई=Garai
आय=Aay
व्यय=Byay
उपलब्धि=Upalabdhi
आगामी=Aagami
कार्यक्रमको=Karyakramko
नियमित=Niyamit
जानकारी=Jankari
राख्नु=Rakhnu
लगानीको=Laganiko
प्रमाणको=Pramanko
अभिलेख=Abhilekh
राष्ट्रिय=Rashtriy
एकता=Ekata
सार्वभौमिकता=Sarvabhaumikata
धार्मिक=Dharmik
सहिष्णुतामा=Sahishnutama
खलल=Khalal
पार्ने=Parne
पनि=Pani
क्रियाकलाप=Kriyakalap
नदिने=Nadine
संख्यामा=Sankhyama
नघट्ने=Naghatne
प्रचलित=Prachalit
कानून=Kanun
योग्यता=Yogyata
पुगेको=Pugeko
मिलाउने=Milaune
छात्रबासमा=Chhatrabasma
स्वस्थकर=Swasthakar
नैतिक=Naitik
चरित्र=Charitra
निर्माणको=Nirmanko
वातावरण=Watawaran
कायम=Kayam
अतिरिक्त=Atirikt
कार्यकलाप=Karyakalap
सञ्चालन=Sanchalan
आवासीय=Aawasiy
तोकिदिए=Tokidie
विद्यार्थीको=Bidyarthiko
पौष्टिक=Paushtik
आहारको=Aaharko
गुणस्तर=Gunastar
शुरुमा=Shuruma
दश=Dash
प्रतिशत=Pratishat
पुर्याउनु=Puryaunu
कार्यालयले=Karyalayale
निर्देशन=Nirdeshan
अनुरुप=Anurup
काम=Kaam
पूर्वाधारहरु=Purbadharaharu
यथावत्=Yathawat
शैक्षिकतथ्यांक=ShaikshikTathyaank
तयार=Tayar
पठाउने=Pathaune
प्रदान=Pradan
स्वीकृतिको=Swikritiko
निरीक्षकवा=NirikshakWa
अधिकृतद्वारा=AdhikritDwara
जाँचबुझसम्बन्धी=JanchabujhSambandhi
प्रतिवेदन=Pratibedan
भएपछि=Bhaepachhi
शर्त=Shart
त्यास्तो=Tyasto
विद्यालयलाई=Bidyalaylai
सञ्चालनभइरहेका=SanchalanBhairaheka
हुँदाका=Hundaka
बखत=Bakhat
संस्थागत=Sansthagat
भइरहेको=Bhairaheko
ऐनले=Ainle
म्यादभित्र=Myadbhitra
कम्पनीमा=Companyma
दर्ता=Darta
प्रमाणपत्र=Pramanpatra
गुठीको=Guthiko
तत्सम्बन्धी=Tatsambandhi
विधान=Bidhan
निस्सा=Nissa
समेत=Samet
संलग्न=Sanlagna
मुनाफा=Munapha
नलिने=Naline
कोउपदफा=KoUpadapha
सार्वजनिक=Sarvajanik
गुठी=Guthi
दिने=Dine
kh=kha
g=ga
gh=gha
ng=nga
ch=cha
chh=chha
j=ja
jh=jha
ny=nya
th=tha
d=da
dh=dha
n=na
p=pa
f=fa
b=ba
bh=bha
m=ma
y=ya
r=ra
w=wa
v=va
s=sa
sh=sha
ksh=ksha
tr=tra
gy=gya
kaa=ka
khaa=kha
gaa=ga
ghaa=gha
chaa=cha
chhaa=chha
jhaa=jha
taa=ta
thaa=tha
daa=da
dhaa=dha
naa=na
paa=pa
faa=fa
baa=ba
bhaa=bha
maa=ma
yaa=ya
raa=ra
laa=la
saa=sa
shaa=sha
sanchai=sanchai
aram=aaram
kasto=kasto
chhain=chhaina
gardai=gardai
khan=khana
basn=basna
garn=garna
h=ha
ri=ri